NNNNNNNNNNNNNNNNNNNNNNNNNNNNNNNNNNNNNNNNNNNNNNNNNNNNNNNNNNNNNNNNNNNNNNNNNNNNNNNNNNNN
NNNNNNNNNNNNNNNNNNNNNNNNNNNNNSSSSSSSSSSSSSNNNNNNNNNNNNNNNNNNNNNNNNNNNNNNNNNNNNNNNNNN
NNNNNNNNNNNNNNNNNNNSSSSSSSSSSSSSSSSSSSSSSSSSSSSSSSSSSSSSSSSSSSSSSNNNNNNNNNNNNNNNNNNN
NNNNNNNNNNNNNNNSSSSSWWWWWWWWWWWWEWWWWWWWWWWWWW#WWWWWWWWWWWWWWWWWSSSNNNNNNNNNNNNNNNNN
NNNNNNNNNNNNNSSSWWWWWWWWWWWWWWWWWWWWWWWWWWWWWWWWWWWWWWWWWWWWWWWWWWSSNNNNNNNNNNNNNNNN
NNNNNNNNNNNNSSWWWWWWWWWWWWWWWWWWWWWWWWWWWWWWWWWWWWWWWWWWWWWWWWWWWWWSSNNNNNNNNNNNNNNN
NNNNNNNNNNNSSWWWWWWWWWWWWWWWWWWWWWWWWWWWWWWWWWWWWWWWWWWWWWWWWWWWWWWWSSNNNNNNNNNNNNNN
NNNNNNNNNSSWWWWWWWWWWWWWWWWWWWWWWWWWWWWWWWWWWWWWWWWWWWWWWWWWWWWWWWWWWWSSNNNNNNNNNNNN
NNNNNNNNNSSWWWWWWWWWWWWWWWWWWWWWWWWRRRRRRRRWWWWWWWWWWWWWWWWWWWWWWWWWWWSSNNNNNNNNNNNN
NNNNNNNNNSSWWWWWWWWWWWWWWWWWWWWWWRRRRRRRRRRRRWWWWWWWWWWWWWWWWWWWWWWWWWSSNNNNNNNNNNNN
NNNNNNNNNSSWWWWWWWWWWWWWWWWWWWWRRRRRRRRRRRRRRRWWWWWWWWWWWWWWWWWWWWWWWWWSSNNNNNNNNNNN
NNNNNNNNNSSWWWWWWWWWWWWWWWWWWWRRRRRRRRRRRRRRRRRWWWWWWWWWWWWWWWWWWWWWWWWWSSNNNNNNNNNN
NNNNNNNNNSSWWWWWWWWWWWWWWWWWWRRRRRRRRRRRRRRRRRRRWWWWWWWWWWWWWWWWWWWWWWWWSSNNNNNNNNNN
NNNNNNNNNSSWWWWWWWWWWWWWWWWWWRRRRRRRRRRRRRRRRRRRWWWWWWWWWWWWWWWWWWWWWWWWWSSNNNNNNNNN
NNNNNNNNNNSSWWWWWWWWWWWWWWWWWWWRRRRRRRRRRRRRRRRRRWWWWWWWWWWWWWWWWWWWWWWWSSNNNNNNNNNN
NNNNNNNNNNNSSWWWWWWWWWWWWWWWWWWWRRRRRRRRRRRRRRRRRRWWWWWWWWKWDWWWWWDWWWKSSNNNNNNNNNNN
NNNNNNNNNNSSWWWWWWWWWWWWWWWWWWWWWRRRRRRRRRRRRRRRRRRWWWWWKWWWWWWWWKWWWWWWSSNNNNNNNNNN
NNNNNNNNNNSSWWWWWWWWWWWWWWWWWWWWWWRRRRRRRRRRRRRRRRRRRRRRRRRRRRORRRRRRRRRRRNNNNNNNNNN
NNNNNNNNNNSSWWWWWWWWWWWWWWWWWWWWWWWRRRRRRRRRRRRRRRRRRRRRRRRRRRRRRRRRRRRRRRRNNNNNNNNN
NNNNNNNNNNSSWWWWWWWWWWWWWWWWWKWWWWWWWRRRRRRRRRRRRRRRRRRRRRRRRRRRRRRRRRRRRRRNNNNNNNNN
NNNNNNNNNNSSWWWWWWWWWWWWWWWWWWWWWWWWWWWRRRRRRRRRRRRRRRRRRRRRRRRRRRRRRRRRRRNNNNNNNNNN
NNNNNNNNNNSSWWWWWWWWWWWWWWWWWWWWWWKWEWKRRRRRRRRRRRRRRRRRRRRRRRRRRRRRRRRRRRNNNNNNNNNN
NNNNNNNNNNSSWWWWWWWWWWWWWWWWWWWKKEWWWWKRRRRRRRRRRRRRRRRRRRRRRRRRRRRRRRRRRNNNNNNNNNNN
NNNNNNNNNNNSSWWWWWWWWWWWWWWWWWWKWWWEWKWWWRRRRRRRRRRRRRRRRRRRRRRRRRRRRRRRNNNNNNNNNNNN
NNNNNNNNNNNNSSWWWWWWWWWWWWWWWWWWWWWWWWWWRRRRRRRRRRRRRRRRRRRRRRRRRRRRRRNNNNNNNNNNNNNN
NNNNNNNNNNNNSSWWWWWWWWWWWWWWWWWWWWWWWWWRRRRRRRRRRRRRRRRRRRRRRRRRRRRRRNNNNNNNNNNNNNNN
NNNNNNNNNNNNSSWWWWWWWWWWWWWWWWWWWWWWWWWRRRRRRRRRRRRRRRRRRRRRRRRRRRRRNNNNNNNNNNNNNNNN
NNNNNNNNNNNNSSWWWWWWWWWWWWWWWWWWWWWWWWWWRRRRRRRRRRRRRRRRRRRRRRRRRNNNNNNNNNNNNNNNNNNN
NNNNNNNNNNNNNSSWWWWWWWWWWWWWWWWWWWWWWWWWWRRRRRRRRRRRRRRRRRRRRRRRRNNNNNNNNNNNNNNNNNNN
NNNNNNNNNNNNNNSSWWWWWWWWWWWWWWWWWWWWWWWWWWRRRRRRRRRRRRRRRRRRRRRNNNNNNNNNNNNNNNNNNNNN
NNNNNNNNNNNNNNNSWWWWWWWWWWWWWWWWWWWWWWWWWWRRRRRRRRRRRRRRRRRRRRNNNNNNNNNNNNNNNNNNNNNN
NNNNNNNNNNNNNNNSWWWWWWWWWWWWWWWWWWWWWWWWWWWWWRRRRRRRRRRRRRRRRRNNNNNNNNNNNNNNNNNNNNNN
NNNNNNNNNNNNNNNSWWWWWWWWWWWWWWWWWWWWWWWWWPWWWWWRRRRRWWWWRRRNNNNNNNNNNNNNNNNNNNNNNNNN
NNNNNNNNNNNNNNNSSWWWWWWWWWWWWWWWWWWWWWWWWWWWWWWWWWWWWWWWWSSNNNNNNNNNNNNNNNNNNNNNNNNN
NNNNNNNNNNNNNNNNSSSWWWWWWWWWWWWWWWWWWWWWWWWWWWWWWWWWWWWWWSSNNNNNNNNNNNNNNNNNNNNNNNNN
NNNNNNNNNNNNNNNNNNSSWWWWWWWWWWWWWWWWWWWWWWWWWWWWWWWWWWWWSSNNNNNNNNNNNNNNNNNNNNNNNNNN
NNNNNNNNNNNNNNNNNNNSSSWWWWWWWWWWWWWWWWWWWWWWWWWWWWWWWWWWWSSSNNNNNNNNNNNNNNNNNNNNNNNN
NNNNNNNNNNNNNNNNNNNNNSSWWWWWWWWWWWWWWWWWWWWWWWWWWWWWWWWWWWSSSNNNNNNNNNNNNNNNNNNNNNNN
NNNNNNNNNNNNNNNNNNNNNNSSSWWWWWWWWWWWWWWWWWWWWWWWWWWWWWWWWWWSSNNNNNNNNNNNNNNNNNNNNNNN
NNNNNNNNNNNNNNNNNNNNNNNNSSSSSSSSSSSSSSSSSSSSSSSSSSSSSSSSSSSSNNNNNNNNNNNNNNNNNNNNNNNN
NNNNNNNNNNNNNNNNNNNNNNNNNNNNNNNNNNNNNNNNNNNNNNNNNNNNNNNNNNNNNNNNNNNNNNNNNNNNNNNNNNNN
NNNNNNNNNNNNNNNNNNNNNNNNNNNNNNNNNNNNNNNNNNNNNNNNNNNNNNNNNNNNNNNNNNNNNNNNNNNNNNNNNNNN