NNNNNNNNNNNNNNNNNNNNNNNNNNNNNNNNNNNNNNNNNNNNNNNNNNNNNNNNNNNNNNNN
NNNNNNNNNNNNNNNNNNNNNNNNNNNNNSSSSSSSSSSSSSNNNNNNNNNNNNNNNNNNNNNN
NNNNNNNNNNNNNNNNNNNSSSSSSSSSSSSSSSSSSSSSSSSSSSSSSNNNNNNNNNNNNNNN
NNNNNNNNNNNNNNNSSSSSWWWWWWWWWWWWWWWWWWWWWWWWWWWWSSSSNNNNNNNNNNNN
NNNNNNNNNNNNNSSSWWWWWWWWWWWWWWWWWWWWWWWWWWWWWWWWWWWSSNNNNNNNNNNN
NNNNNNNNNNNNSSWWWWWWWWWWWWWWWWWWRRRRRRRRRRRRRRRWWWWWSSNNNNNNNNNN
NNNNNNNNNNNSSWWWWWWWWWWWWWWWWWWRRRRRRRRRRRRRRRRRWWWWWSSNNNNNNNNN
NNNNNNNNNSSWWWWWWWWWWWWWWWWWWWRRRRRRRRRRRRRRRRRRWWWWWWSSNNNNNNNN
NNNNNNNNNSSWWWWWWWWWWWWWWWWWWRRRRRRRRRRRRRRRRRRRWWWWWWSSNNNNNNNN
NNNNNNNNNSSWWWWWWWWWWWWWWWWWWRRRRRRRRRRRRRRRRRR#WWWWWWSSNNNNNNNN
NNNNNNNNNSSWWWWWWWWWWWWWWWWWWRRRRRRRRRRRRRRRRRRRWWWWWWSSNNNNNNNN
NNNNNNNNNSSWWWWWWWWWWWWWWWWWWRRRRRRRRRRRRRRRRRRRWWWWWWSSNNNNNNNN
NNNNNNNNNSSWWWWWWWWWWWWWWWWWWRRRRRRRRRRRRRRRRRRRWWWWWWSSNNNNNNNN
NNNNNNNNNSSWWWWWWWWWWWWWWWWWWRRRRRRRRRRRRRRRRRRRWWWWWWSSNNNNNNNN
NNNNNNNNNNSSWWWWWWWWWWWWWWWWWWWRRRRRRRRRRRRRRRRRRWWWWWSSNNNNNNNN
NNNNNNNNNNNSSWWWWWWWWWWWWWWWWWWWRRRRRRRRRRRRRRRRRRWWWWSSNNNNNNNN
NNNNNNNNNNNNSSWWWWWWWWWWWWWWWWWWWRRRRRRRRRRRRRRRRRRWWSSNNNNNNNNN
NNNNNNNNNNNNNSSWWWWWWWWWWWWWWWWWWWRRRRRRRRRRRRRRRRRRRSNNNNNNNNNN
NNNNNNNNNNNNNNSSWWWWWWWWWWWWWWWWWWWRRRRRRRRRRRRRRRRRRRNNNNNNNNNN
NNNNNNNNNNNNNNNSSSWWWWWWWWWWWWWWWWWWWRRRRRRRRRRRRRRRRRRNNNNNNNNN
NNNNNNNNNNNNNNNNNSSWWWWWWWWWWWWWWWWWWWWRRRRRRRRRRRRRRRNNNNNNNNNN
NNNNNNNNNNNNNNNNNSSWWWWWWWWWWWWWWWWWWWWRRRRRRRRRRRRRRRNNNNNNNNNN
NNNNNNNNNNNNNNNNNSSWWWWWWWWWWWWWWWWWWWWRRRRRRRRRRRRRRRNNNNNNNNNN
NNNNNNNNNNNNNNNNNNSSWWWWWWWWWWWWWWWWWWWWWRRRRRRRRRNNNNNNNNNNNNNN
NNNNNNNNNNNNNNNNNNSSWWWWWWWWWWWWWWWWWWWWRRRRRRRRNNNNNNNNNNNNNNNN
NNNNNNNNNNNNNNNNNNNSSWWWWWWWWWWWWWWWWWWRRRRRRRRNNNNNNNNNNNNNNNNN
NNNNNNNNNNNNNNNNNNNSSWWWWWWWWWWWWWWWWWWRRRRRRRRNNNNNNNNNNNNNNNNN
NNNNNNNNNNNNNNNNNNNNSSWWWWWWWWWWWWWWWWWWRRRRRRRRNNNNNNNNNNNNNNNN
NNNNNNNNNNNNNNNNNNNNNSSWWWWWWWWWWWWWWWWWWRRRRRRRRNNNNNNNNNNNNNNN
NNNNNNNNNNNNNNNNNNNNNNSSWWWWWWWWWWWWWWWWWWRRRRRRNNNNNNNNNNNNNNNN
NNNNNNNNNNNNNNNNNNNNNNNSSSWWWWWWWWWWWWWWWWRRRNNNNNNNNNNNNNNNNNNN
NNNNNNNNNNNNNNNNNNNNNNNNSSSSSSSSSSSSSSSSSSRNNNNNNNNNNNNNNNNNNNNN
NNNNNNNNNNNNNNNNNNNNNNNNNNNNNNNNNNNNNNNNNNNNNNNNNNNNNNNNNNNNNNNN