NNNNNNNNNNNNNNNNNNNNNNNNNN
NRRCRRRRRRRRRRRRRRRRRRRRRN
NRRRRRRRHHHHHHHHHHRRRRRRRN
NRRHRRRRHHHHHHHHHHTRRRRCRN
NRR#RRRRRRRRRRRRRRRRRRRRRN
NRRRHHRHHRHHRRHHRHHRHHRRRN
NRRRHHRHHRHHRRHHRHHRHHRRRN
NRRRRRRRRRRRRCRRRRRRRRRRRN
NRHHTRRRRRHHHHHHHHRRRRHHRN
NRRRRRRRRRRRRRRRRRRRRRRRRN
NRHHRHHRRRRHHRRHHRTHHRHHRN
NCRRRHHHHHHHHRRHHHHHHRRRRN
NRRRRRRRRRRRRRRRRRRRRRCRRN
NNNNNNNNNNNNNNNNNNNNNNNNNN