############################+############
#*#+++#+++#+++#+++++++++++++#+++#+++++++#
#+#+#+#+#+###+++###########+###+#####+###
#+++#+#+#+#+++++#+++#+++++#+++#+++++#+++#
#+###+#+#+#+#+###+#+###+###+++###+#+#+++#
#+++#+#+#+++#+++#+#+++#+++++#+#+++#+++#+#
#+###+#+#######+#+###+#####+#+#########+#
#+#+++#+++#+++#+#+++#+++++#+#+++++++++#+#
#+#+#####+#+#+#+###+#####+###########+#+#
#+#+++++#+++#+#+++#+#+++#+#+++#+#+++++#+#
#+#+###+#+###+#+###+#+#+#+#+#+#+#+#####+#
#+#+++#+#+++#+#+++#+#+#+#+++#+++++#+++++#
#+###+#+#####+###+#+#+#+#####+#####+#+###
#+#+++#+#+++++++#+#+++#+++++#+++#+#+#+#+#
#+#+###+#+#######+#########+###+#+#+#+#+#
#+#+#+++#+++#+++#+++#+++++#+#+#+#+++#+#+#
#+###+#####+#+#+###+#+###+#+#+++#####+#+#
#+++#+#+#+++#+#+++++#+#+++#+#+++#+++++#+#
#+#+#+#+#+###+#######+#+###+#+###+#####+#
#+#+#+#+++++#+#+++++#+#+++#+#+#+#+++++++#
###+#+#####+#+###+#+#+###+#+#+#+#####+#+#
#+++#+++++#+#+++#+#+#+#+++#+#+++#+++++#+#
#+#####+#+#+###+#+###+#+###+#####+#+###+#
#+#+++#+#+#+++#+#+++#+#+#+++++#+++#+#+#+#
#+#+###+#####+#+###+#+###+###+#+###+#+#+#
#+#+++#+++++++#+#+++#+++++#+#+++#+++#+++#
#+###+###########+#######+#+#+#########+#
#+#+++#+++#+++++#+#+++#+++++#+++#+++++++#
#+#+#####+#+###+#+#+#+###########+#######
#+#+#+++++#+++#+++#+++++++++#+#+++#+++++#
#+#+#+#####+#######+#######+#+#+###+#+#+#
#+++#+++#+#+++++++++++#+++#+++++#+++#+#+#
#+#####+#+###########+#+#+###########+#+#
#+++#+++#+++++#+++#+++#+#+++++++++++++#+#
###+#+#####+#+#+#+#+#+#+###########+###+#
#+#+++#+++#+#+#+#+#+#+++#+++++++#+++#+++#
#+#+###+#+#+#+###+#+#####+#####+#######+#
#+#+#+#+#+#+#+++++#+++++#+#+++#+++#+++#+#
#+#+#+#+###+#######+###+#+#+#+###+#+#+#+#
#+++++#+++++#+++++++#+++++++#+++++#+#++@#
#########################################