############################+############
#+#+++#+++#+++#+++++++++++++#+++#+++++++#
#+++#+#+#+###+++###########+###+#####+###
#+++#+#+#+#+++++#+++#+++++#+++#+++++#+++#
#+###+#+#+#+#+###+#+###+###+++###+++#+++#
#+++#+#+#+++#+++#+#+++#+++++#+#+++#+++#+#
#+###+#+#######+#+###+#####+#+#########+#
#+#+++#+++#+++#+#+++#+++++#+#+++++++++#+#
#+#+#####+#+#+#+###+#####+###########+#+#
#+#+++++#+++#+#+++#+#+++#+#+++#+#+++++#+#
#+#+###+#+###+#+###+#+#+#+++#+++++#####+#
#+#+++#+#+++#+#+++#+#+#+#+++#+++++#+++++#
#+###+#+#####+###+#+#+#+#####+#####+#+###
#+#+++#+#+++++++#+#+++#+++++#+++#+#+#+#+#
#+#+###+#+#######+#########+###+#+#+#+#+#
#+#+#+++#+++#+++#+++#+++++#+#+#+#+++#+#+#
#+###+#####+#+#+###+#+###+#+#+++#####+#+#
#+++#+#+#+++#+#+++++#+#+++#+#+++#+++++#+#
#+#+#+#+#+###+#######+#+###+#+###+#####+#
#+#+#+#+++++#+#+++++#+#+++#+#+#+#+++++++#
###+#+#####+#+###+#+#+###+#+#+#+#####+#+#
#+++#+++++#+#+++#+#+#+#+++#+#+++#+++++#+#
#+#####+#+#+###+#+###+#+###+#####+#+###+#
#+#+++#+#+#+++#+#+++#+#+#+++++#+++#+#+#+#
#+#+###+#####+#+###+#+###+###+#+###+#+#+#
#+#+++#+++++++#+#+++#+++++#+#+++#+++#+++#
#+###+###########+#######+#+#+#########+#
#+#+++#+++#+++++#+#+++#+++++#+++#+++++++#
#+#+#####+#+###+#+#+#+###########+#######
#+#+#+++++#+++#+++#+++++++++#+#+++#+++++#
#+#+#+#####+#######+#######+#+#+###+#+#+#
#+++#+++#+#+++++++++++#+++#+++++#+++#+#+#
#+#####+#+###########+#+#+###########+#+#
#+++#+++#+++++#+++#+++#+#+++++++++++++#+#
###+#+#####+#+#+#+#+#+#+###########+###+#
#+#+++#+++#+#+#+#+#+++#+++++++++#+++#+++#
#+#+###+#+#+#+###+#+#####+#####+#######+#
#+#+#+#+#+#+#+++++#+++++#+#+++#+++#+++#+#
#+#+#+#+###+#+#####+###+#+#+#+###+#+#+#++
#+++++#++++++#++++++#+++++++#+++++#+#++++
######################################++@